name	writer
魔導具師ダリヤはうつむかない	甘岸久弥
【3/10書籍2巻発売】ゴブリン令嬢と転生貴族が幸せになるまで　　婚約者の彼女のための前世知識の上手な使い方	新天新地
【コミック2月発売】ループ7回目の悪役令嬢は、元敵国で自由気ままな花嫁生活を満喫する	雨川 透子
聖女の魔力は万能です	橘由華
転生した大聖女は、聖女であることをひた隠す	十夜
ブラック魔道具師ギルドを追放された私、王宮魔術師として拾われる　～ホワイトな宮廷で、幸せな新生活を始めます！～【Web版】	葉月秋水
真実の愛を見つけたと言われて婚約破棄されたので、復縁を迫られても今さらもう遅いです！【書籍化・コミカライズ連載中】	彩戸ゆめ
【書籍3/17発売】無能才女は悪女になりたい～義妹の身代わりで嫁いだ令嬢、公爵様の溺愛に気づかない～	一分咲
【web版】無口な公爵令嬢と冷徹な皇帝～前世拾った子供が皇帝になっていました～	ベキオ
悪役令嬢、ブラコンにジョブチェンジします	浜千鳥
小国の侯爵令嬢は敵国にて覚醒する 【書籍発売中・コミカライズ】	守雨
手札が多めのビクトリア〜元工作員は人生をやり直し中〜【書籍発売中・コミック連載中】	守雨
転生王女は今日も旗を叩き折る。	ビス
【書籍4巻3/10発売】元、落ちこぼれ公爵令嬢です。（WEB版）	一分咲
悪役令嬢は溺愛ルートに入りました！？	十夜
今度は絶対に邪魔しませんっ！	空谷玲奈
【コミカライズ配信中】愛さないといわれましても～元魔王の伯爵令嬢は生真面目軍人に餌付けをされて幸せになる【１巻発売中】	豆田　麦
僕は婚約破棄なんてしませんからね	ジュピタースタジオ
悪役令嬢の中の人【書籍化・コミカライズ】	まきぶろ
【書籍化・コミカライズ】三食昼寝付き生活を約束してください、公爵様	チカフジ　ユキ
【書籍化＆コミカライズ】わたし、聖女じゃありませんから	長月 おと
ティアムーン帝国物語　～断頭台から始まる、姫の転生逆転ストーリー～	餅月望
乙女ゲームの破滅フラグしかない悪役令嬢に転生してしまった…	山口悟
【書籍化・コミカライズ】ループ中の虐げられ令嬢だった私、今世は最強聖女なうえに溺愛モードみたいです（WEB版）	一分咲
【書籍化】美人の姉が嫌がったのでどう見ても姿絵が白豚の次期伯爵に嫁ぎましたところ	真波潜
義妹が聖女だからと婚約破棄されましたが、私は妖精の愛し子です	桜井ゆきな
悪役令嬢の中の人	まきぶろ
聖女じゃなかったので、王宮でのんびりご飯を作ることにしました	神山 りお
婚約者に裏切られたので、子爵令嬢から王妃付き侍女にジョブチェンジしてみた	雉間ちまこ
真の聖女である私は追放されました。だからこの国はもう終わりです【書籍化】	鬱沢色素
【書籍化＆コミカライズ】関係改善をあきらめて距離をおいたら、塩対応だった婚約者が絡んでくるようになりました	雨野六月
歴史に残る悪女になるぞ	大木戸　いずみ
１００日後に死ぬ悪役令嬢は毎日がとても楽しい。（Web版）	ゆいレギナ
【番外編】ふつつかな悪女ではございますがWeb版	中村 颯希
【WEB版】転生したら１５歳の王妃でした　〜聖女のチートなんて興味がないし、気ままにおいしいごはんを作ります～	斧名田マニマニ
【Web版】オリビア魔石宝飾店へようこそ～家と店を追い出されたので、王都に店をかまえたら、なぜか元婚約者と義妹の結婚式に出ろと言われました～	優木凛々
弱気MAX令嬢なのに、辣腕婚約者様の賭けに乗ってしまった	小田 ヒロ
悲劇の元凶となる最強外道ラスボス女王は民の為に尽くします。〜ラスボスチートと王女の権威で救える人は救いたい〜	天壱
婚約破棄を狙って記憶喪失のフリをしたら、素っ気ない態度だった婚約者が「記憶を失う前の君は、俺にベタ惚れだった」という、とんでもない嘘をつき始めた	琴子
【完結】完璧すぎて可愛げがないと婚約破棄された聖女は隣国に売られる【コミックス第２巻発売中】	冬月光輝
やり直し令嬢は竜帝陛下を攻略中	永瀬さらさ
【書籍化＆コミカライズ決定】義姉の代わりに、余命一年と言われる侯爵子息様と婚約することになりました	瑪々子
転生先で捨てられたので、もふもふ達とお料理します　　　～お飾り王妃はマイペースに最強です～	桜井 悠
【コミカライズ・書籍化】ななしの皇女と冷酷皇帝 ～虐げられた幼女、今世では龍ともふもふに溺愛されています～	藍上イオタ
悪虐聖女ですが、愛する旦那さまのお役に立ちたいです。（とはいえ、嫌われているのですが）	雨川 透子
後悔するならご勝手に～あなたの選んだ聖女様とどうぞお幸せに～	桜井ゆきな
【2巻10/4】嫌われ妻は、英雄将軍と離婚したい！いきなり帰ってきて溺愛なんて信じません。	柊 一葉
【コミカライズ】女神様がやっちまいなとの思し召しです	まゆらん
聖女が来るから君を愛することはないと言われたのでお飾り王妃に徹していたら、夫と聖女の様子がおかしいのですが	宮之みやこ＠「5歳聖女」3/10発売
家から逃げ出したい私が、うっかり憧れの大魔法使い様を買ってしまったら	琴子
謙虚、堅実をモットーに生きております！	ひよこのケーキ
 お隣の天使様にいつの間にか駄目人間にされていた件	佐伯さん
お見合いしたくなかったので、無理難題な条件をつけたら同級生が来た件について【第六巻　スニーカー文庫より12／28発売！】	桜木桜
【web版】クラスで陰キャの俺が実は大人気バンドのボーカルな件	夜桜ユノ【『クラスで陰キャ』コミック発売しました！】
俺にトラウマを与えた女子達がチラチラ見てくるけど、残念ですが手遅れです	御堂ユラギ
【書籍化】有名Vtuberの兄だけど、義妹が配信切り忘れたら、なぜか俺が有名になった～陰キャだからと振られた俺が、超人気ブラコン妹の兄として注目され、期待の新人Vとしてデビューするけど今更なんですか？	茨木野
【WEB版】高校生WEB作家のモテ生活 「あんたが神作家なわけないでしょ」と僕を振った幼馴染が後悔してるけどもう遅い【書籍版好評発売中！】	茨木野
日本語が話せないロシア人美少女転入生が頼れるのは、多言語マスターの俺1人	アサヒ
風間君の嘘は彼女達にはバレバレです　～入れ替わりは元に戻ってからがラブコメです！～	まきま
【書籍化】窓際編集とバカにされ、妻に浮気されたその日から、双子JKと同居することになった〜新しい職場と美少女達が家で待つ幸せな新生活を送ってるので、今更有能編集だったと気付いて謝られても相手にしません	茨木野
ネトゲの嫁が人気アイドルだった件　～クール系の彼女は現実でも嫁のつもりでいる～	あボーン
夢見る男子は現実主義者	おけまる
実家に帰ったら甘やかされ生活が始まりました	月夜乃 古狸
【12/1発売】俺は知らないうちに学校一の美少女を口説いていたらしい〜バイト先の相談相手に俺の想い人の話をすると彼女はなぜか照れ始める〜	午前の緑茶
転生先が現代日本人ってふざけんなっ！ って思ったけどそれが普通だし案外充実してる	せん
隣の席になった美少女が惚れさせようとからかってくるがいつの間にか返り討ちにしていた	荒三水
転生者の私に挑んでくる無謀で有望な少女の話	小東のら
現代社会で乙女ゲームの悪役令嬢をするのはちょっと大変	二日市とふろう (旧名:北部九州在住)
転校先の清楚可憐な美少女が、昔男子と思って一緒に遊んだ幼馴染だった件【web版】	雲雀湯
モテない陰キャ平社員の俺はミリオンセラー書籍化作家であることを隠したい！　～転勤先の事務所の美女3人がＷＥＢ作家で俺の大ファンらしく、俺に抱かれてもいいらしい、マジムリヤバイ！〜	鉄人じゅす
戦地から帰ってきたタカシ君。普通に高校生活を送りたい	安い芸
【Web版】陰キャの僕に罰ゲームで告白してきたはずのギャルが、どう見ても僕にベタ惚れです	結石
『書籍化！』百合ゲー世界なのに男の俺がヒロイン姉妹を幸せにしてしまうまで	流石ユユシタ
【WEB版】高嶺の花だらけな名門校で、学院一のお嬢様（生活能力皆無）を陰ながらお世話することになりました	サケ/坂石遊作
【連載版】「オタクはキモいから無理」と恋人に浮気され振られた夜、オタクに優しいギャルと付き合うことになった〜実は優良物件だったと今更気づいても遅い、清楚系美人となった趣味の合う元ギャルとラブラブです	茨木野
【書籍化】幼馴染彼女のモラハラがひどいんで絶縁宣言してやった	斧名田マニマニ
学校では地味な陰キャとバカにされている俺は実はボディーガード　〜地味に生きたいのに、以前助けた有名人の幼馴染が離してくれない〜	木嶋隆太
お前みたいなヒロインがいてたまるか！	白猫
ホラー女優が天才子役に転生しました　～今度こそハリウッドを目指します！～	鉄箱
【web版】会話もしない連れ子の妹が、長年一緒にバカやってきたネトゲのフレだった	雲雀湯
幼馴染も義妹も……誰も俺を信じてくれなかった。今さら信じているなんて言われても、もう手遅れです	野良うさぎ(うさこ)
【書籍版発売中】S級学園の自称「普通」、可愛すぎる彼女たちにグイグイ来られてバレバレです。	丸山ひま。
転生リベンジ芸能人ライフ～不遇だったアイドルオタクな青年、謎の死を遂げた推しアイドル少女の命を救うため、二度目の人生で芸能界へ飛び込む～	ハーーナ殿下
手塩にかけて育てたアイドルたちに裏切られた俺は、自殺しようとしていた元人気アイドルのプロデューサーになる	とによ
友人キャラの俺がモテまくるわけないだろ？	【世界一】とにかく可愛い超巨乳美少女ＪＫ郷家愛花２４歳【可愛い】
ラブコメ漫画に入ってしまったので、推しの負けヒロインを全力で幸せにする	shiryu
霜月さんはモブが好き	八神鏡@『霜月さんはモブが好き』コミカライズ＆4巻発売中！
【本編完結済み・書籍化】世界一かわいい俺の幼馴染が、今日も可愛い	青季 ふゆ
【3巻10/25発売】月50万もらっても生き甲斐のない隣のお姉さんに30万で雇われて「おかえり」って言うお仕事が楽しい【書籍化＆コミカライズ】	黄波戸井ショウリ
冤罪で大切な人達に傷付けられた少年、無実の罪だと分かった後に謝られても絶対に許さない	リョウタ
君のせいで今日も死ねない	飴月
【書籍化】陰キャだった俺の青春リベンジ 天使すぎるあの娘と歩むReライフ	慶野由志
【完結】高校生に戻った俺、両想いだったはずの幼馴染に振られたので、学校一の美少女と心中してみた	【世界一】とにかく可愛い超巨乳美少女ＪＫ郷家愛花２４歳【可愛い】
センパイ、自宅警備員の雇用はいかがですか？【4月20日 二巻発売予定】	二上圭＠じたこよ三巻、１１月発売。
幼馴染がカースト上位に君臨している	Cost
時々ボソッとロシア語でデレる隣のアーリャさん	燦々SUN
【書籍化】尽くしたがりなうちの嫁についてデレてもいいか？	斧名田マニマニ
【Web版】麗子の風儀～悪役令嬢と呼ばれましたが、ただの貧乏娘です～	ベキオ
【Web版】人脈チートで成り上がる地下アイドルプロデュース〜ビラ配りしていた売れない地下アイドルの人生変えてみた〜【コミカライズ】	津ヶ谷
痴漢冤罪で捕まったクラスの王子を、俺ひとりだけ信じ続けたら、王子が姫になった	スカイ・ノーレッジ
ヘルモード　～やり込み好きのゲーマーは廃設定の異世界で無双する～	ハム男
とんでもスキルで異世界放浪メシ	江口　連
無職転生　- 異世界行ったら本気だす -	理不尽な孫の手
【アニメ放送中！】陰の実力者になりたくて！【web版】	逢沢大介
お気楽領主の楽しい領地防衛  〜生産系魔術で名もなき村を最強の城塞都市に〜	赤池宗
大ハズレだと追放された転生重騎士はゲーム知識で無双する	猫子
一億年ボタンを連打した俺は、気付いたら最強になっていた～落第剣士の学院無双～	月島 秀一
限界超えの天賦《スキル》は、転生者にしか扱えない　ー　オーバーリミット・スキルホルダー	三上康明
魔術師クノンは見えている	南野海風
俺は全てを【パリイ】する　〜逆勘違いの世界最強は冒険者になりたい〜	鍋敷
本好きの下剋上　～司書になるためには手段を選んでいられません～	香月　美夜
異世界のんびり農家	内藤騎之介
転生して田舎でスローライフをおくりたい	錬金王
蜘蛛ですが、なにか？	馬場翁
ありふれた職業で世界最強	厨二好き/白米良
【連載版】信じていた仲間達にダンジョン奥地で殺されかけたがギフト『無限ガチャ』でレベル９９９９の仲間達を手に入れて元パーティーメンバーと世界に復讐＆『ざまぁ！』します！	明鏡シスイ
最強出涸らし皇子の暗躍帝位争い～帝位に興味ないですが、死ぬのは嫌なので弟を皇帝にしようと思います～	タンバ
転生したらスライムだった件	伏瀬
ハズレ枠の【状態異常スキル】で最強になった俺がすべてを蹂躙するまで	篠崎芳
貴族転生～恵まれた生まれから最強の力を得る	三木なずな
デスマーチからはじまる異世界狂想曲（ web版 ）	愛七ひろ
元・世界１位のサブキャラ育成日記 ～廃プレイヤー、異世界を攻略中！～	沢村治太郎(合成酵素)
五年間働いていた治療師ギルドを不当解雇された“最弱”な俺。生きるために超有能スキルで‟最強”を目指します	岡本剛也
【Web版】町人Aは悪役令嬢をどうしても救いたい【後日談のみ連載中】	一色孝太郎
水属性の魔法使い	久宝　忠
神達に拾われた男（改訂版）	Roy
没落予定の貴族だけど、暇だったから魔法を極めてみた	三木なずな
私、能力は平均値でって言ったよね！	FUNA
おい、外れスキルだと思われていた《チートコード操作》が化け物すぎるんだが。　〜実家を追放され、世間からも無能と蔑まれていたが、幼馴染の皇女からめちゃくちゃ溺愛されるうえにスローライフが楽しすぎる〜	どまどま@チートコード操作　書籍化&amp;コミカライズ
Ｒｅ：ゼロから始める異世界生活	鼠色猫/長月達平
【本編完結】信者ゼロの女神サマと始める異世界攻略	大崎 アイル
追放されたお荷物テイマー、世界唯一のネクロマンサーに覚醒する　〜ありあまるその力で自由を謳歌していたらいつの間にか最強に〜	すかいふぁーむ
黒鳶の聖者　〜追放された回復術士は、有り余る魔力で闇魔法を極める〜	まさみティー
異世界のんびり素材採取生活	錬金王
落ちこぼれ国を出る〜実は世界で４人目の付与術師だった件について〜	御影　雫
万能「村づくり」チートでお手軽スローライフ　～村ですが何か？～	九頭七尾
転生貴族の異世界冒険録～自重を知らない神々の使徒～【アニメ化決定】	夜州
世界最強の努力家　〜才能が【努力】だったので効率良く規格外の努力をしてみる〜	蒼乃白兎
八男って、それはないでしょう！　	Ｙ．Ａ
【WEB版】王都の外れの錬金術師 ～ハズレ職業だったので、のんびりお店経営します～【書籍化、コミカライズ】	yocco
片田舎のおっさん、剣聖になる　～ただの田舎の剣術師範だったのに、大成した弟子たちが俺を放ってくれない件～	佐賀崎しげる
嘆きの亡霊は引退したい　〜最弱ハンターは英雄の夢を見る〜【Web版】	槻影
一瞬で治療していたのに、何もしてないとパーティを追放された天才治癒師～今さら戻ってこいと言われても、闇ヒーラーとして楽しくやっているので治療は高額になるけどおたくら払えますか？～	ひかさく＠菱川さかく
くまクマ熊ベアー	くまなの
【Web版】転生貴族、鑑定スキルで成り上がる～弱小領地を受け継いだので、優秀な人材を増やしていたら、最強領地になってた～	未来人A
魔王と勇者の戦いの裏で　～ゲーム世界に転生したけど友人の勇者が魔王討伐に旅立ったあとの国内お留守番（内政と防衛戦）が俺のお仕事です～	涼樹悠樹
転生したら剣でした	棚架ユウ
異世界迷宮で奴隷ハーレムを	蘇我捨恥
そのおっさん、異世界で二周目プレイを満喫中	月夜　涙（るい）
【書籍完結＆コミカライズ化】【本編・外伝完結済】剣聖の幼馴染がパワハラで俺につらく当たるので、絶縁して辺境で魔剣士として出直すことにした。（ＷＥＢ版）	シンギョウ　ガク
世界最速のレベルアップ　～無能スキル【ダンジョン内転移】が覚醒した結果、俺だけダンジョンのルールに縛られず最強になった～	八又ナガト
現実世界に現れたガチャに給料全部つぎ込んだら引くほど無双に	ARATA
乙女ゲー世界はモブに厳しい世界です	三嶋　与夢
特級探索師への覚醒　～蜥蜴の尻尾切りに遭った青年は、地獄の王と成り無双する～	笠鳴小雨
モンスターがあふれる世界になったので、好きに生きたいと思います	よっしゃあっ！
Ｄジェネシス　ダンジョンができて３年（web版）	之 貫紀
俺にはこの暗がりが心地よかった	星崎崑
アラフォー賢者の異世界生活日記	寿　安清
異世界食堂	犬塚惇平（犬派店主）
社畜ですが、種族進化して最強へと至ります	力水
災悪のアヴァロン 【書籍2巻 1/19発売】	鳴沢明人
【書籍化】現代陰陽師は転生リードで無双する	爪隠し
百合ゲー世界に、百合の間に挟まる男として転生してしまいました	とまとすぱげてぃ
冒険家になろう！　スキルボードでダンジョン攻略(WEB版)	萩鵜アキ
【書籍化】転生陰陽師・賀茂一樹【＆コミカライズ決定】	赤野用介
ダンジョンおじさん【Web版】	広路なゆる＠ダンジョンおじさん四巻執筆中
モブ高生の俺でも冒険者になればリア充になれますか？	百均
10年ごしの引きニートを辞めて外出したら自宅ごと異世界に転移してた	坂東太郎
村づくりゲームのＮＰＣが生身の人間としか思えない	昼熊
ログアウトしたのはＶＲＭＭＯじゃなく本物の異世界でした ～現実に戻ってもステータスが壊れている件～	とーわ
ハズレスキル「逃げる」で俺は極限低レベルのまま最強を目指す　～経験値抑制＆レベル１でスキルポイントが死ぬほどインフレ、スキルが取り放題になった件～	天宮暁
宝くじで40億当たったんだけど異世界に移住する	すずの木くろ
神の庭付き楠木邸【４巻3/17発売】	えんじゅ
ネトオク男の楽しい異世界貿易紀行	星崎崑
転生したので、たった一人で地球と貿易してみる　～ゲーム好き魔術少女の冒険譚～	あかい
異世界居酒屋「のぶ」	蝉川夏哉/逢坂十七年蝉
極東救世主伝説～極東で生まれたやべーやつは如何にして救世主と呼ばれるようになったか～	仏ょも
『ショップ』スキルさえあれば、ダンジョン化した世界でも楽勝だ　～迫害された少年の最強ざまぁライフ～	十本スイ
家の猫がポーションとってきた。	熊ごろう
【更新再開】庭に穴ができた。ダンジョンかもしれないけど俺はゴミ捨て場にしてる【書籍発売＆コミカライズ企画進行中】	ダイスケ
世界の闇と戦う秘密結社が無いから作った（半ギレ）	黒留ハガネ
その無限の先へ	二ツ樹五輪(*´∀｀*)
セブンス	三嶋　与夢
裏庭ダンジョンで年収120億円	三上康明
【書籍2巻発売中】攻略！大ダンジョン時代─俺だけスキルがやたらポエミーなんだけど─【本編第二部毎日更新】	てんたくろー/天鐸龍
ダンジョンで潮干狩りを	大正
【書籍化&amp;コミカライズ！】最強で最速の無限レベルアップ　～スキル【経験値1000倍】と【レベルフリー】でレベル上限の枷が外れた俺は無双する～(web版)	シオヤマ琴@コミカライズ2作、書籍化1作準備中
朝起きたらダンジョンが出現していた日常について……	ポンポコ狸
【書籍化】この世界がいずれ滅ぶことを、俺だけが知っている【コミカライズ連載中】	灰島シゲル
「書籍化」モブな主人公　〜小説の中のモブだけど問題がある	バッド
モブから始まる探索英雄譚	海翔
異世界帰りのパラディンは、最強の除霊師となる	Ｙ．Ａ
異世界魔法は遅れてる！	鼻から牛肉／樋辻臥命
地球さんはレベルアップしました！	生咲日月
平穏に生きたい【ステータスオール１】は今日も今日とて世界を救う。	鍋敷
#壊れた地球の歩き方 【コミカライズ連載開始＆書籍二巻発売中！】	ヤマモトユウスケ@#壊れた地球の歩き方 発売中！
魔力即時回復スキルで現代ダンジョン無双　〜規格外のスキルで爆速レベルアップ→超一流探索者も引くほど最強に〜	可換　環
音使いは死と踊る	弁当箱
地獄の沙汰も黄金次第　～会社をクビになったけど、錬金術とかいうチートスキルを手に入れたので人生一発逆転を目指します～	出雲大吉
 凡人探索者のたのしい現代ダンジョンライフ　【書籍化決定　2023年】	しば犬部隊
【超短編】逆行する令嬢の真相	越智屋ノマ 
短編【王妃になった姉妹の結末】廃妃は二度目の恋を知る	越智屋ノマ 
トロッコ問題とその最適解	間野ハルヒコ
婚約破棄による経済効果	yuyu
塔の陰	礎衣 織姫
余命3000文字	村崎羯諦
『妖精騎士の物語 』　少女は世界を変える	ペルスネージュ
悪魔の花嫁【連載式コミカライズ配信中】	村岡みのり
娘の誕生日会に誰も来なかった	たらこくちびる毛
婚約破棄交渉九十九回目、のちに……。	あいより碧
余命30000文字	つこさん。
引っ越してきた隣人が庭に竹を植え始めた	たらこくちびる毛
竜と妻	とびらの
【１】宮廷書記官リットの優雅な生活	鷹野　進
太宰治、異世界転生して勇者になる　～チートの多い生涯を送って来ました～	高橋弘
主人公だけが忘れる死に戻り	天帷 碧緒
イカロスの恋	そら
今日も電波塔で龍が死んでいる	ふとんねこ
夫が仕事から帰って「夕食は？」と聞くと妻は「カップ麺よ」と言い放つ	エタメタノール
妻に媚薬を盛ってみた	鈴本耕太郎
婚約破棄の現場で～王子様の本音～	Ash
彼にとって、愛とはそういうものだった	ほねのあるくらげ
あと５分で世界が滅びると言われたので、私はカップラーメンを食べることにした	鞠目
異世界で魔王を倒してきた元勇者ですが、こちらに戻ってきても就職口がありませんでした。	(=｀ω´=)
下っ端妃は逃げ出したい	都茉莉
オーバーエイジ38　～ベテラン・サッカー選手は老いることを知らない～	高坂岬
黒髪少女と真夜中の神社でビスケットを食べる	優木凛々
君を守るため、僕は何度でも死に戻る	羽田遼亮
人類を滅ぼすシミュレーションゲーム	えるえる
心を読む聖女	水紅
太宰治、異世界転生して勇者になる　～チートの多い生涯を送って来ました～【連載版】	高橋弘
ギルドカードの遺言	えるえる
世界一簡単な合法殺人	下城米雪＠ワンオペ解雇コミカライズ連載中
私が犯した罪について	たなか
食べログ1.8のラーメン屋	村崎羯諦
ネコチャンと天国で会う時の注意点	ヒロモト
１０年不倫	青井青
バカだけを殺すウイルス	えるえる
徒然ww	京野うん子
愚者の独白	高槻いつ
転性のノスタルジア	都森メメ
先月お父さんが誘拐されたけど、身代金はまだ支払ってません	村崎羯諦
【２】宮廷書記官リットの有閑な日常	鷹野　進
耳の聞こえない風俗嬢	青井青
わたしが勇者の残機ドナーに登録した理由	志雄崎あおい
共鳴する	はなぶさ
王子と王女の婚約締結	ほねのあるくらげ
もう、いらない	三香
隣の芝生は枯れていた	あなぐらグラム
親子鑑定	青井青
目的は生き延びること	大菊小菊
男なら一国一城の主を目指さなきゃね	三度笠
え、社内システム全てワンオペしている私を解雇ですか？【書籍化・コミカライズ】	下城米雪＠ワンオペ解雇コミカライズ連載中
百花宮のお掃除係～転生した新米宮女、後宮のお悩み解決します。	黒辺あゆみ
今更自由といわれても	西木田
【12月15日書籍発売】公爵夫人の秘密の日記――白い結婚を申し入れたら、渡りに船と言われました。	横浜 山笑（旧山笑）
がんばって最高の遺書を書いたら、なぜか &quot;ざまあ&quot; することになりました	優木凛々
周囲が羨む「ツンデレ幼馴染」を捨てるのは間違っているのか	まきぶろ
大陸英雄戦記	悪一
【短編版】婚約破棄を宣言した王子と、悪役令嬢は階段から落ちた·····そして2人は叫んだ「私達、入れ替わっている！？」と	夕景あき
冤罪令嬢の肖像画～とある画家が人生最高の肖像画を描いた話～	優木凛々
素人おっさん、転生サッカーライフを満喫する	ハーーナ殿下
最凶侯爵の逆鱗に触れた者達の末路	やとぎ
美人な妹と、私	ユウキ
婚約者が高貴なご令嬢と愛し合ってるようなので、私は身を引きます。…どうして困っているんですか？	越智屋ノマ 
夢から醒めて	あさな
逆行転生したおじさん、性別も逆転したけどバーチャルYouTuberの親分をめざす！	ブーブママ
メニューをどうぞ【WEB版】	雛／汐邑雛
期待されなかった僕たちは	瀬嵐しるん
後妻のお義母様とお義姉様が屋敷に来て、私は何故か幸せになりました。	浅村鈴
純粋な疑問の方が酷なこともある	海狸
悪役令嬢、庶民に堕ちる【web版】	緋月紫砲
別に要りませんけど？	ユウキ
男女比がぶっ壊れた世界の人と人生を交換しました	もぎ　すず
【web版】美少女にTS転生したから大女優を目指す！【書籍化】	武藤かんぬき
義妹の嫌がらせで、子持ち男性と結婚する羽目になりました。継母として、義理の娘に嫌われることも覚悟していましたが、そこでようやく本当の家族を手に入れることができました。	石河 翠
【書籍&amp;コミック発売中】余命六ヶ月延長してもらったから、ここからは私の時間です	編乃肌
やり直してもサッカー小僧	黒須　可雲太
おっさん、転生して天才役者になる	ほえ太郎
アラサーのオレは別世界線に逆行再生したらしい	翠川稜
気が付いたら競走馬に生まれ変わっていました。でも、競馬の知識は０なんです！	南辺万里
冷遇妻だけど、夫に愛されていたようです。知るか。	瀬尾優梨
そんな俺は、廃太子。《　転生王子の逃避、あるいは　安寧への力業　》	龍槍　＠　リハビリ中
異世界チート知識で領地経営しましょう	加藤　良介
ないがしろにされた令嬢は、不幸の元凶を排除することにした	優木凛々
晴れて国外追放にされたので魅了を解除してあげてから出て行きました	ラララオキ
エルフさんの魔法料理店	夜塊織夢 
鈍金色のリリーフエース〜常勝球団で酷使されていた俺は、弱小球団のホワイト環境で無双する〜	筆箱鉛筆
とある魔球のダウンザライン！	うるめいわし
聖女追放！………とは直接関係なかった子爵様	ハーピスト 
【書籍・漫画化しました！】異世界メイドの三ツ星グルメ ～現代ごはん作ったら王宮で大バズリしました～【旧題・美食おぼっちゃまの転生メイド】	モリタ
いつか貴女の手を引けるように。	黛ちまた
辺境伯子息の独白	里見しおん
おおそといっき！	うるめいわし
【短編】国王陛下は王子のフリを見て我がフリを反省した	宇水涼麻
婚約破棄は別に良いのですが、貴方が自慢げに見せているそれは国家機密ですわよ？	はぐれメタボ
アラサーがVTuberになった話。	とくめい
婚約者に裏切られた私は熊より強くなりました	秋雨ルウ（レビューしてた人）
真実の愛に婚約破棄を叫ぶ王太子より更に凄い事を言い出した真実の愛の相手	ラララオキ
初夜に「俺がお前を抱く事は無い！」と叫んだら長年の婚約者だった新妻に「気持ち悪い」と言われた上に父にも予想外の事を言われた男とその浮気女の話	ラララオキ
戦国小町苦労譚	夾竹桃
戦国時代に宇宙要塞でやって来ました。	横蛍
偽典・演義　～とある策士の三國志（仮）～	仏ょも
淡海乃海　水面が揺れる時	イスラーフィール
転生！　竹中半兵衛　マイナー武将に転生した仲間たちと戦国乱世を生き抜く	青山　有
羽林、乱世を翔る（異伝　淡海乃海 水面が揺れる時）	イスラーフィール
三日月が新たくなるまで俺の土地！～マイナー武将「新田政盛」に転生したので野望MAXで生きていきます～	篠崎冬馬
戦武成伝　－武田に転生したと思ったら想像してたのと違う甲斐武田から枝分かれした安芸武田のさらに枝分かれの若狭武田だったので、滅亡しないように武をもって成り上がります－	尾羽内 鴉
【書籍化】令和の化学者・鷹司耀子の帝都転生　～プラスチック素材で日本を救う～【旧題：鷹は瑞穂の空を飛ぶ】	雨堤俊次/コモンレール
本能寺から始める信長との天下統一  ©歴史知識は必要なし ９巻２月２５日発売 オーバーラップ文庫 電撃大王連載中  電撃コミックスNEXT ３巻10/27発売・１８１，０００，０００PV突破	常陸之介寛浩★ＯＶＬ５金賞受賞☆アルファ第4回歴史時代小説読者賞
銭（インチキ）の力で、戦国の世を駆け抜ける。（本編完結）（コミカライズ開始）	Ｙ．Ａ
ルイ16世に転生してしまった俺はフランス革命を全力で阻止してアントワネットと末永くお幸せに暮らしたい【WEB連載版】	スカーレッドG
【漫画単行本発売中】斎藤義龍に生まれ変わったので、織田信長に国譲りして長生きするのを目指します！【本編完結】	巽未頼
織田家の長男に生まれました	いせひこ/大沼田伊勢彦
魯鈍の人（ロドンノヒト）  ～信長の弟、信秀の十男と言われて～	牛一（ドン）
加賀100万石に仕える事になった	シムCM
戦国生存記	現実逃避
陶都物語～赤き炎の中に～	まふまふ
【本編完結】小物武将、木村吉清　豊臣の天下で成り上がる！　(旧題)マイナー戦国武将に転生したのでのんびり生きようと思ったら、いきなり30万石の大名になってしまいました	田島はる
信長の庶子	壬生一郎
武田信虎　～暴君から名君へ～	なんじゃもんじゃ
冬嵐記	槐
戦国時代に転移したと思ったら俺だけRPGだった！	したらば
じゃない孔明転生記。軍師の師だといわれましても	二水うなむ
項羽と劉邦、あと田中	古寺谷 雉
未来から吹いた風　～５人でひっくりかえす太平洋戦争～	青雲あゆむ
痛快娯楽時代劇　小田氏治	藤永太郎
三田一族の意地を見よ	三田弾正
復興名家の仮名目録　～戦国転生異聞～　（旧名：殿と仮名目録の追加案件）	シムCM
風神天翔記　～とある修羅の転生事情～	仏ょも
海道一ノ弓取リ	葉室 貫之
討ち死になんて勘弁な	悠夜
貴族になったが、未来がヤバかった	やがみ
信長公弟記～織田さんちの八男です～【コミカライズ連載中】	彩戸ゆめ
天地海　～無名武将に転生したので天下は諦めて新潟港を発展させる～	今川幸乃
稲荷様は平穏に暮らしたい	茶トラの猫
北政所様の御化粧係〜戦国の世だって美容オタクは趣味に生きたいのです〜	笹倉のり
生まれ変わったら曹昂だった。　前世の知識を活かして宛城の戦いで戦死しないで天寿を全うします	 雪国竜
航空エンジニアのやり直し　～航空技術者は二度目に引き起こされた大戦から祖国を守り抜く～	御代出　実葉
董卓の娘	神奈いです
転生三法師の奮闘記  ～魔王の孫とよばれて〜	夜鷹
六芒星が頂に～星天に掲げよ！ 二つ剣ノ銀杏紋～	縞杜コウ(縞守皐駕)
江雲記―六角定頼に転生した舐めプ男の生涯―	藤瀬慶久
戦国蒸溜所 ～スピリッツ・オブ・バトルエイジ～	漸減サカヤキ
悪役令嬢の十五年戦争　 ～転生先は戦前の日本？！　このままじゃあ破滅フラグを回避しても駄目じゃない！！～	扶桑かつみ
時霞　～信長の軍師～　【長編完結】	水野忠
【文庫化】信長と征く　転生商人の天下取り	入月英一
阿武隈の狼	平良中
首取り物語：北条・武田・上杉の草刈り場でザマァする。ところでみんな・・・・現実を見ようか。こいつらの首取るのは大変なんだヨォ～～～！主人公以外全員ガチです。	天のまにまに
オール・ユー・ニード・イズ・吉良～死に戻りの赤穂事件～	左高例
薬屋のひとりごと	日向夏
婚約破棄の日の夜に	夕景あき
吾輩は魔王であるが、四天王になぜか監禁されている	コーチャー
勇者が死んだので三等書記官は魔王城へ行きます	コーチャー
伯爵夫人の遺書	水谷繭
異世界の名探偵（旧題:ファンタジーにおける名探偵の必要性）	片里鴎(カタザト)
彼ぴっぴしゅきしゅきビーム殺人事件	経済的ゾンビ
レベル１の俺が魔王を倒すと言ったら、みんな笑った。でも、前世が名探偵だったおかげで本当に倒してしまい……	からくらり
聖女様を殺したのは誰ですか？	コーチャー
誰が聖女を殺したか？	榛名丼
勇者一行は死ななければならない	コーチャー
佐伯さんの下着が透けてることを後ろの席の僕だけが知っている〜ところで佐伯さん、毎日帰り際にボソッと下着の色を教えてくるのはなんでなの？〜	麻田セカイ　
王子様は一級死亡フラグ建築士　～城からパクってきた銀のスプーンが黒く変色した件～	藤原ゴンザレス
『飽きた』と書いた紙で異世界に行けたけど、破滅した悪役令嬢の代役だった	枝豆ずんだ
盲目の織姫は後宮で皇帝との恋を紡ぐ	小早川真寛
最高の勇者を殺す一つの方法	コーチャー
時計屋の兎（ラビット）	狭山ひびき
勇者様の死体を見つけちゃったんですけど！	コーチャー
マネーロンダリング～二億円の行方	青い鯖
《連載》ヒロインは途中退場させられましたが、全て元に戻るだなんて、そうは問屋が卸さない	きなこ
キモオタでギャルゲー、それって何の罰ゲーム！？	天満川鈴
囁くヴァニタス	中村 颯希
死に掛け女のぐーたら疫神生活	楠瑞稀
劣等刑事の勘違い逮捕伝　～車で犯人ひきまくってたら出世しました～	馬路まんじ＠PV公開（主人公：赤羽根健治 ヒロイン：逢田梨香子）
【コミカライズ連載中】塔の医学録　～悪魔に仕えたメイドの記～	澁澤まこと
呪われるたび強くなる。スキル『呪具耐性』を授かりました。あれから十数年、名家から追い出された貴族の次男坊。ひとり身おっさんのもんもんスローライフ。	三神カミ
【書籍化、コミカライズ】《第三章完結》愛読家、日々是好日〜慎ましく、天衣無縫に後宮を駆け抜けます〜	琴乃葉
ギルドの受付嬢は人間を殺せない	コーチャー
絶体絶命悪役令嬢	8D
逃走犯はオトコノコ！	青い鯖
異世界クイズ王　～妖精世界と七王の宴～	ＭＵＭＵ
本気で「偽善者」はじめたら、たくさんの人に感謝され、なりゆきで巨大犯罪組織まで壊滅させ、いつの間にか世界70億人の命を救ってたんだが。	実時 彰良
王国の令嬢が帝国に嫁入りするのは、戦争回避のため	白澤　睡蓮
血みどろの婚約破棄は仕組まれていた	白澤　睡蓮
その事件の１人目の被害者は、悪役令嬢である　～サスペンスな世界に転生したら、婚約者か弟か殺人鬼に殺されそうです～	宮崎
アラサーがJKに転生して楽しいのか？	別所 燈 
ステータスが見えるようになった俺は君を絶対に救い出す！　～俺と天使の事件捜査ファイル～	藤原ゴンザレス
イレギュラーな魔術師（旧版）	常高院於初
正しいアイコラの作り方	水月一人
殺人遺伝子	菱川あいず
聖女殺しの婚約者	浮夜海月
人狼メイドはブラック法廷に異議を申し立てる	今際之キワミ
【短編】「また異世界誘拐が流行り始めたんだってよ！」	まほりろ／若松咲良
探偵など要らない学園生活	塚山　凍
勇者の悲劇	コーチャー
異世界医院〜一期一会〜	モロ平野
【書籍化】後宮の嫌われ白蛇妃ですが、推しのためなら悪意も美味しくいただきます！ 〜えーっと、殿下は推しじゃないです。なので溺愛はご遠慮ください〜	碧水雪乃＠『嫌われ白蛇妃』スターツ出版文庫から1/27発売
ギルドの受付嬢は空を見上げる	コーチャー
姫様また誘拐されたんですか	コーチャー
推理令嬢シャーロットの事件簿～謎解きは婚約破棄のあとで～	あけちともあき
オカルトちゃんねる【連載版】	lpp
婚約破棄の行方	彩戸ゆめ
ホラー映画の幼女が魔王の元に召喚されました。	エノコモモ
 クラス転移とか無理なので	芍薬甘草
「真の聖女様、ですか？　ええ、もちろん歓迎いたしますよ」	わんこそば
見たら絶対に死ぬ”呪いのビデオ”を手に入れたのに、幻のマイナー規格”HD-DVD”に録画されてるせいで再生できません（泣）	大萩おはぎ
娘が「悪役令嬢」に憑り殺された日。あるいは、あの子が死んだ日の話	紫苑
今更「許せ」と言われても	アンドレイ
ただひたすら走って逃げ回るお話	残念無念
ゆるコワ！　～無敵の女子高生二人がただひたすら心霊スポットに凸しまくる！～	谷尾銀
召喚聖女の落とし穴	江葉
死刑囚、魔法学校にて教鞭を振るう	無道
神田、おれだよ	ナチ
山内くんの呪禁の夏。	二宮酒匂
クラス全員からいじめを受けている僕は絶対呪われる駅の連絡通路に凸して実況ムービー撮ってきます。	闇黒猫虎
その悪役令嬢は壊れている	伊藤@
【書籍化】妹がいじめられて自殺したので復讐にそのクラス全員でデスゲームをして分からせてやることにした	駆威 命（元駆逐ライフ）【書籍化】妹がいじめられて～発売中
クラス一の美少女が、駅ホームで不思議な踊りを踊っていた	BAWさん
【悲報】時間停止モノAV、９割がヤラセだった	大萩おはぎ
生存者インタビュー	青井青
名前のない怪物	黒木京也
自分がオカズにされた回数が分かる女の子	ヒロモト
ある悪役令嬢への手紙	端野ハトコ
引きこもりだけど、外にゾンビがうろついている	上野羽美
悩める王子と呪いの言葉	長月 おと
悪役令嬢の処刑の、その先は。	しののめ。
ブレーメンの屠殺場	NiO
幼馴染が吊り橋効果を狙って肝試しに行こうと誘って来たから、全部の心霊現象解明してムードもへったくれもない状態にしようと思う	玄武聡一郎
【連載版】御気の毒ですが、呪いが発動しました	猫田 トド
乗っ取られたら乗っ取り返せばいいのですよ、王妃さま。	牧村 多希
もしもサイコパスがデスゲームに巻き込まれたらこうなります	無道
絶対に逃げられない最恐の異世界”きさらぎ駅”の謎を解いて脱出します！	大萩おはぎ
怪異の掃除人	長埜 恵
ループ100回目の悪役令嬢ですのでお望み通りヒロインいじめてみました	にょん
底辺貴族で【スライム召喚】しか出来なくて美少女にイジメられてた俺、キレて顔面に召喚魔法を使ったら脳みそを乗っ取ることに成功　～バレたらやばいので奴隷にした美少女にヨイショさせながら権力を手に入れます～	馬路まんじ＠PV公開（主人公：赤羽根健治 ヒロイン：逢田梨香子）
ヤクザな退魔外伝　神無沼	モロクっち
いきなり、ただの肉屋に騎士がきた	伊藤@
婚約破棄を回避した悪役令嬢は今日から幸せになります。だから、	紫苑
もう人間くらいしか食べる物がないこの世界で、どうして僕らは出会ったのだろう	帰初心
【復讐譚】お姉様に差し上げますわ	茅野ガク
断罪の魔女	ゆうき
亡くなった妻が駅のホームで線路の方に引きずり込もうとしてくる件。	闇黒猫虎
うそつきの子〈山内くんの呪禁事件簿〉	二宮酒匂
悪役令嬢の独白	碓井桂
最近、死神が追いかけて来る夢を見ます。毎晩少しずつ距離が縮まって、次はもう逃げ切れそうにありません。	大萩おはぎ
転生して名もなき雑草になりました。正式名称はアランフィオレンティーナといいますが、誰も呼んでくれません	三香
守護霊（？）は鎌倉武士	ほうこうおんち
本当は怖い異世界物語	馬渡
ヒロイン達が全員俺のことを生理的に無理な話	夜明
顧問の先生が素手で幽霊を殴るんだが、どこかおかしいのだろうか？	くろぬか
リビルドワールド	非公開
マヌケなFPSプレイヤーが異世界へ落ちた場合	地雷原
【書籍第2巻10/5発売！】わしジジイ、齢六十を超えてから自らの天賦の才に気付く【コミカライズ】	しんこせい(『お助けキャラ』1巻2/24発売！)
コボルト無双 ❧ |樹|º▿º*) ̖́- 最底辺のかませ犬が征く!	shiba
異世界支配のスキルテイカー　～　ゼロから始める奴隷ハーレム　～	柑橘ゆすら
異世界ＳＦ！　ＦＰＳ！　『カラフ撤退戦』	黒色粉末
【収納空間】を極める男　～モンスターを狩りたいので誰よりも【収納空間】を使い込んでいたら、色々な事件に巻き込まれてしまう。『俺はモンスターを狩りたいだけなのにぃ！』～	森たん
失格王子の成り上がり冒険譚～出来損ないはいらないと王家を追い出された俺、規格外の『器』で世界最強の冒険者になる～	未来人A
12ハロンのチクショー道【書籍化】	野井ぷら
人型巨大兵器〝に〟転生しました〜冷凍世界再点火〜	白色矮星
俺の家が魔力スポットだった件～住んでいるだけで世界最強～	あまうい白一 
引き籠もりヒーロー	(*■∀■*)
エルフに転生した元剣聖、レベル１から剣を極める -Hero Swordplay Breakdown-	大虎龍真
外れスキル『予報』が進化して『言ったら実現』になる件☆レンガ・レンガ・レンガ！でスローライフしてます	天野優志
チートスキル『死者蘇生』が覚醒して、いにしえの魔王軍を復活させてしまいました〜誰も死なせない最強ヒーラー〜	はにゅう@『木の実マスター』発売中！
アルケミスト・スタートオーバー ～誰にも愛されず孤独に死んだ天才錬金術師は幼女に転生して人生をやりなおす～	エルトリア
迷宮で石ころは光り輝く	乙黒
イマドキのサバサバ冒険者	埴輪庭
啼かないカナリアの物語　～ 声を出せない魔法使いと模造の小鳥の探しもの ～	綾村実草【カナリア第一巻発売中です！】　
希望のクライノート　～魔法戦士は異世界限定ガチャを回す～	オスカる
『灰色乙女の流離譚』　私は自分探しの旅に出る【完結】　	ペルスネージュ
王宮の仕事を追放された魔導具使いの俺は幼少期の男の友情を信じて昔の仲間たちに集まってもらったらなぜかハーレムパーティになっていた。今更戻れと言われても…やっぱ遅くね？	LENA
【最終章開幕】傷跡の聖者	イエニー・コモリフスキ
勇者代理なんだけどもう仲間なんていらない	ジガー
[完結しました！] 僕は、お父さんだから（書籍名：遺伝子コンプレックス）	舛本つたな
鋼鉄のアイ	大紀直家@パブロン
召喚世界のアリス	天野ハザマ
婚約破棄されたので全員殺しますわよ ～素敵な結婚を夢見る最強の淑女、２度目の人生～	とうもろこし
魔導機人アルミュナーレ	凜乃　初
 英雄《しゅやく》になれない槍使い	笹木さくま（夏希のたね）
魔法少女のヒーロー	てふてふてふ
ラドゥと旅路と獣狩り	あびすけ
帰還者《リターナー》は平穏に暮らせない	幽霊@ファベーラ
ラグナロク	安井健太郎
勇者の称号を剥奪されたおっさん、これ幸いとバカンスに行った先で魔王さんと遭遇する　～夏のあばんちゅーる～	ぽんこつ少尉
出涸らし王子と悪役令嬢――ＶＲＭＭＯＲＰＧの世界に転生したかったのに、乙女ゲーの世界で悪役令嬢の婚約者をやっている僕	成瀬真
骸鬼王と、幸福の花嫁たち【第9部、二日置き更新！】	雨宮ソウスケ
黄金の国の狩人	神誠
白銀のヘカトンケイル	北十五条東一丁目
【完結】国賊王女のサーバントに転生したら、特殊スキル「武器庫（アーモリー）」が覚醒しました！	石和￥
C級師匠のS級冒険者育成計画	風緑
石ころ冒険者	亜蒼行
ハーフ・ヴァンパイア創国記	高城@SSK
青年と犬と、もう一人	Schuld 
たとえ夜を明かすのに幾億の剣戟が必要だとしても【Web版】（書籍版タイトル:幾億もの剣戟が黎明を告げる）	御鷹穂積
チートを拒否した最強魔術士。転移先で無能扱いされるが最強なので何の問題もなかった	やとぎ
日常系アニメとカマキリ拳法〜武術を身につけた最強のアニオタが、無双しながらアニオタライフを楽しむ話〜	魔人ボルボックス
私、竜の巫女の見習い！　今日もお仕事頑張りますっ！！	波多野まな
戦禍切り裂け、明日への剣聖 ⚔ The Knight Wizards!!	shiba
生産職を極め過ぎたら伝説の武器が俺の嫁になりました	あまうい白一 
即死チートが最強すぎて、異世界のやつらがまるで相手にならないんですが。【TVアニメ化決定！】	藤孝剛志
「第二王子が婚約破棄したってよ！」	八月 あやの
「いいか、ハーレムっていうのはな！」	八月 あやの
【書籍化】後宮という名の魔境をデスループで切り抜けてきたら、皇帝にブチ切れられました	かざなみ
【書籍化】廃公園のホームレス聖女	荒瀬ヤヒロ
大根ですが、おでんパーティから追放されました。パーティの野菜成分を俺が一手に担っていたんだが、大丈夫かな	ななみや
子どもが書いた夏休みの作文が、ファンタジーすぎる件	Aska
王太子に婚約破棄されていたら「ずるいずるい」という妹が乱入してきました。	荒瀬ヤヒロ
【奇跡のコミカライズ！】婚約者は私を捨てて妹を選びましたが、妹は時限爆弾でした【作者の日常も吹っ飛びました！】	関宮亜門
オットー・フォン・ハイデッカーはゲーム脳。	王石　勉
【書籍化・コミカライズ】偽・聖剣物語　～幼なじみの聖女を売ったら道連れにされた～	溝上 良
女神『異世界転生何になりたいですか』　俺「勇者の肋骨で」	安泰
そのガーゴイルは地上でも危険です　～翼を失くした最強ガーゴイルの放浪記～　	大地の怒り
親戚の小学生の算数の文章題がおかしい	唯乃なない
転生吸血鬼さんはお昼寝がしたい	ちょきんぎょ。
『男女比 １：３０ 』 世界の黒一点アイドル	ヒラガナ
クソ雑魚メンタルなTS娘はマッマの所為でVTuberデビュー	totto
ラスボスの向こう側～最強の裏ボス＝邪神に転生したけど、１０００年誰も来ないから学園に通うことにした～	天音のわる
「私って男っぽくてサバなのよね」誰なんだよ俺との見合いにサバを呼んだやつは	quiet
笑顔で魔力チャージ～無限の魔力で異世界再生	三木なずな
妹の配信に入り込んだらVTuber扱いされた件	江波界司
教会務めの神官ですが、勇者の惨殺死体転送されてくるの勘弁して欲しいです【連載版】	夏川優希
追放された聖女様は、とりあえず昼寝することにした	優木凛々
異世界で美少女になった俺、地球に戻れたので裏垢やってみる。	貯水庫
百万回転生した俺は、平和な世界でも油断しない	稲荷竜
裏側からこの状況を説明します	徒然花
転生して天才子役になってみたけど、もうやめたいです。	インド人を右に
となりの魔王	ナチ
異世界ガーデニング　－アルの造園物語－	乾物屋
超実力主義な勇者パーティ	優木凛々
古竜なら素手で倒せますけど、これって常識じゃないんですか？　（きょとん）	羽田遼亮
異世界召喚が多すぎて女神様がぶちギレました【連載版】	湯立向日/ガタガタ震えて立ち向かう
悪徳領主ルドルフの華麗なる日常	増田匠見（旧master1415）
俺は偽勇者～仲間と別れて早数年、なんか復讐されかけている～	藍澤 建
【短編】追放した回復術師が、ハーレムを連れて「ざまぁ」と言いに来た	夏目くちびる
最低皇子たちによる皇位争『譲』戦　～貧乏くじの皇位なんて誰にでもくれてやる！～	榎本快晴
「さあ、回復してやろう」と全回復してきた魔王様、ついに聖女に転生する	延野正行
冒険者「伝説の聖剣を手に入れた……よし売ろう！」	麦酒
夜道でいかにも幽霊っぽい女性を乗せたので、とりあえずコーナー攻めてみた	燦々SUN
多分僕が勇者だけど彼女が怖いから黙っていようと思う	花果 唯
クラス召喚されたけどそれどころじゃない	燦々SUN
その令嬢は祈りを捧ぐ	ユウキ
「これは契約結婚だ。君は何もする必要はない」と言い渡された侯爵夫人、「ただの契約なら複数と結んでも良くない？」と気付き片っ端からお飾り結婚契約締結、大惨事へ	quiet
義妹に虐げられる不憫姉の中身が悪女に乗っ取られた話	りったん
【短編】寡黙な戦士、追放に同調する～だって、もう遅いが見たかったんだもん～	大紀直家@パブロン
王子！　婚約破棄がどうとか以前に誰とも婚約できないまま学園生活終わっちゃったッスよ！	quiet
あなたが拾ったのは普通の女騎士ですか？　それともゴミクズ系女騎士ですか？	溝上 良
「一万人の男と寝た」と豪語する令嬢と結婚した僕、生まれた娘が僕と血は繋がってないことはもちろん承知してるけど、鑑定魔法で「娘の本当の父親が誰かは明らかにしておこう」と言ったら妻が猛烈に焦り始めた	エタメタノール
不死王の息子	日向夏
マンガを読めるおれが世界最強～嫁達と過ごす気ままな生活	三木なずな
シャングリラ・フロンティア〜クソゲーハンター、神ゲーに挑まんとす〜	硬梨菜
出遅れテイマーのその日ぐらし	棚架ユウ
新しいゲーム始めました。～使命もないのに最強です？～	じゃがバター
痛いのは嫌なので防御力に極振りしたいと思います。	夕蜜柑
【堂々完結】ブレイドスキル・オンライン　～ゴミ職業『サモナー』で最弱武器『弓使い』でクソステータス『幸運値極振り』の俺、いつのまにか『ラスボス』に成り上がります！～	馬路まんじ＠PV公開（主人公：赤羽根健治 ヒロイン：逢田梨香子）
＜Infinite Dendrogram＞-インフィニット・デンドログラム-	海道　左近
サモナーさんが行く	ロッド
Free Life Fantasy Online ～人外姫様、始めました～	子日あきすず
Only Sense Online	アロハ座長
『Curse Nightmare Party』-邪眼妖精が征くVRMMO	栗木下
未実装のラスボス達が仲間になりました。	ながワサビ64
骸骨魔術師のプレイ日記	毛熊
打撃系鬼っ娘が征く配信道！	箱入蛇猫
黄金の経験値【なろう版】	原純
Magica Technica　～剣鬼羅刹のVRMMO戦刀録～	Ａｌｌｅｎ
【書籍二巻発売中‼】お前のような初心者がいるか！　不遇職『召喚師』なのにラスボスと言われているそうです【Web版】	魚虎・瀧岡くるじ
ゲート・オブ・アミティリシア・オンライン	翠玉鼬
設定鍵インベントリア：シャンフロの諸々	硬梨菜
Frontier World ―召喚士として活動中―	ながワサビ64
射程極振り弓おじさん	草乃葉オウル
美少女になったけど、ネトゲ廃人やってます。	星屑ぽんぽん
職業、仕立屋。淡々と、VRMMO実況。	わだくちろ
ＶＲＭＭＯの支援職人　～トッププレイヤーの仕掛人～	二階堂風都
最新のゲームは凄すぎだろ	うきせくさこ
やがて最強のPKキラー（職業：商人）【旧題：やがて最強のPKK（職業：商人）】	aaa168
テイマー姉妹のもふもふ配信　～もふもふをもふもふする最愛の妹がとってもかわいいので配信で自慢してみます～	龍翠
もふもふと楽しむ無人島のんびり開拓ライフ ～VRMMOでぼっちを満喫するはずが、全プレイヤーに注目されているみたいです～（旧題：Iris Revolution Online）	紀美野ねこ
アインの伝説　～気づいた時にはもう遅い？　転生したら滅んだ村の生き残りで、勇者の幼なじみなのになかなか名前を思い出してもらえないという極めつけの脇役だったんだけどさ、どうしたらいいと思う？～	相生蒼尉
ジェノサイド・オンライン 〜極悪令嬢のプレイ日記〜	たけのこ
Mebius World Online　〜ゲーム初心者の真里姉と行くVRMMOのんびり？　体験記〜【コミカライズ３巻２０２３年１月７日発売！】【小説１〜３巻発売中】	風雲　空
Hunter and Smith Online	栗木下
ランダムでキャラを作ったんだが詰んだかもしれない	牡羊座の山羊
《Blade　Online》	夜之兎/羽咲うさぎ
掲示板の皆さま助けてください	いそがばまわる
元最強女番長が征く！VRMMO放浪記 -a Faraway Arcadia Online-	ツナ82
えむえむおー！　僕なりの楽しみ方	鴨鹿
【2023/01/10発売】『ライフで受けてライフで殴る』これぞ私の必勝法	こまるん
引っ込み思案な神鳥獣使い ―プラネット イントルーダー・オンライン―	古波萩子
《完結》『Hereafter Apollyon Online』～超高クオリティクソゲーの生産職で巨大ロボット造って遊ぼうとしてるのですが何故か勘違いされます～	西沢東＠コミカライズ企画進行中！
変態ＰＳさんのＶＲ冒険譚	猫又　寝子
ソロ神官のVRMMO冒険記　～どこから見ても狂戦士です本当にありがとうございました～	原初
Skill Build Online ～変態スナイパーによるMMORPG挑戦記～	立華凪
ギスギスオンライン	ココナッツ野山
【漫画単行本3巻発売中】神獣郷オンライン！〜『器用値極振り』で聖獣と共に『不殺』で優しい魅せプレイを『配信』します！〜	時雨オオカミ
最強の女傭兵　近未来でスポーツ美少女となる	のこのこ大王
Ｒ．Ｇ．Ｏ！	旭／星畑旭
城落としとサバイバル	Ceez
読書好きが始めるVRMMO（仮）	天　トオル
ガイド役の天使を殴り倒したら、死霊術師になりました　～皆とは別ゲーをしている気がしますが、私は元気です～	エリーゼ
アナザー・フロンティア・オンライン　～生産系スキルを極めたらチートなNPCを雇えるようになりました～	ぺんぎん
俺は星間国家の悪徳領主！	三嶋　与夢
目覚めたら最強装備と宇宙船持ちだったので、一戸建て目指して傭兵として自由に生きたい	リュート
あたしの悪徳領主様!!　～俺は星間国家の悪徳領主！　外伝～	三嶋　与夢
【４巻発売】乙女ゲームのハードモードで生きています	赤野用介
【連載版】キモオタモブ傭兵は、身の程を弁(わきま)える	土竜
私掠宇宙船から始める特務軍歴	中文字
僕と彼女と実弾兵器（アンティーク）	Gibson
完結&amp;番外編更新中　宇宙戦争掲示板ー1人なんかおかしいのがいるけどー	福郎
III count  Dead END	吹雪
死んでやる～彼女を寝取られ、死ぬに死にきれないヘタレが巻き起こす宇宙活劇～	のらしろ
宇宙船をもらった男、もらったのは星だった！？	山口遊子
カタツムリの貨客船業務日誌	土竜
若者のスペースオペラ離れを嘆く女神様に宇宙船をもらったんだが、引きこもるにはちょうどいい	小鳥遊彰吾
魔王と勇者が時代遅れになりました	結城忍
堕ちた大地で冒険者〜チート技術と超速レベルアップによる異星無双〜	謙虚なサークル
追放された伯爵公子は、超文明の宇宙要塞を手に入れました。	いつき旧太郎
アルビオン王国宙軍士官物語～クリフエッジと呼ばれた男～（クリフエッジシリーズ合本版）	愛山　雄町
ネメシス戦域の強襲巨兵【新刊7巻発売】	夜切　怜
なんかすごい性能の宇宙船を拾った	工具
エルフ・インフレーション　～際限なきレベルアップの果てに～	細川　晃
銀河ネットで仮想空間に潜ったら宇宙船の艦長に成りました。	戸川　八雲
【短編】ファンタジー用チートで万全の準備をしたのに転移したのはＳＦの世界でした。	東堂大稀（旧：To-do）
惑う星の解決法	守野伊音
【大】魔導師様、目覚める！	そういち
日雇い提督は仁愛を得て英雄へと至る	桜華　絢爛
不運なソーヤの運送屋	橋広功
クビにされた元エースパイロットが死んだ婚約者そっくりの幼女を引き取って親子になる話	梅上
ようこそ大宇宙へ！　超古代の巨大宇宙船で宇宙を征く	稲葉小僧
34歳のオッサンによるフォルトリア星系戦記	八鶴ペンギン
月にうさぎはいないけど、誰にも言えない秘密がある	優木凛々
日雇い提督・Ⅱ　神将は独立勢力を創始する～集結せよ！銀河の梁山泊へ～　　　　　　　　	桜華　絢爛
ギガファウナ　―超巨大生物の惑星―	白石健司
キモオタモブ傭兵は、身の程を弁(わきま)える	土竜
【一章完結】 AI使いの冒険者、ドローンとハッキングで無双する　～手段を選ばず金儲けしていたら宇宙一の大富豪になっていました～	田島はる
死者の船と最果ての少女	ほげ山くん
Hi-G. -ハイスピードガールズ ディスタンス-	赤川
クリフエッジシリーズ第一部：「士官候補生コリングウッド」	愛山　雄町
クリフエッジシリーズ第三部：「砲艦戦隊出撃せよ」	愛山　雄町
宇宙の片隅でスローライフ	よぎそーと／ファンティアやってる
クリフエッジシリーズ第五部：「巡航戦艦インヴィンシブル」	愛山　雄町
クリフエッジシリーズ第二部：「重巡航艦サフォーク５：孤独の戦闘指揮所（ＣＩＣ）」	愛山　雄町
うさんくさい宇宙戦艦SFモノ。	maisen
クリフエッジシリーズ第四部：「激闘！　ラスール軍港」	愛山　雄町
彗星の魔女	ヘロー天気
Planetreconstruction Company Online【VRMMO運営側＋惑星改造企業再建】	タカセ
天の川銀河の屠龍戦艦	月汰元
脱走兵は静かに暮らしたい　～最強兵器と共に異世界転移した俺、のんびり旅してたら英雄になってた～	宮葉ヒロアキ
多分……、宇宙もの……。	わだつみ
クリフエッジシリーズ外伝：「英雄の弟：ファビアン・コリングウッド」	愛山　雄町
三匹が宇宙をゆく！ーおっさんの悠々自適なセカンドライフだったと思うのだが何か違う気がする。ー	士口 十介
日本国召喚	みのろう
銀河連合日本	柗本保羽
俺のロボ	温泉卵
未来世界には古流がない！～対戦格闘型ＸＲゲームで古流剣術を使ったら掲示板がざわついた～	鼻から牛肉／樋辻臥命
Doggy House Hound	ポチ吉
「「神と呼ばれ、魔王と呼ばれても」」	しまもん（なろう版）
人類が増えすぎたので減らしてほしいと頼まれました【本編完結済】	にゃんきち
腹ペコ要塞は異世界で大戦艦が作りたい - World of Sandbox -	てんてんこ
玉葱とクラリオン	水月一人
王国騎士団を追放された俺、前世のゲーム知識で『漆黒の英雄』に成り上がる　～自国が滅んだがそんなの知らん。俺は剣と魔法とロボの世界で無双する～	馬路まんじ＠PV公開（主人公：赤羽根健治 ヒロイン：逢田梨香子）
プニキとはじめるリーグ運営　～野球ゲーム？作って運営します～	ブーブママ
「気が触れている」と王家から追い出された俺は、自説通りに超古代銀河帝国の植民船を発見し大陸最大国家を建国する。　～今さら帰って来てくれと言っても、もう遅い！　超テクノロジーを駆使した俺の建国史～	英　慈尊
ロボットアニメの艦長キャラに転生したが、このままでは謀殺されてしまいます	甘味亭太丸
砂漠と鋼とおっさんと	ゴエモン
ポンコツ宇宙船拾得顛末記（仮）	野乃たんぽぽ
実は俺、宇宙船を育てています《イイエ、育てられているのは、ア・ナ・タ》	夢見る黄龍
悠久の機甲歩兵	竹氏
貞操観念が逆転した宇宙人の軍隊でエースパイロットの俺だけが唯一男な話【書籍化決定！】	寒天ゼリヰ
Heavens Under Construction（EP5）	高山 理図 
銀河連合日本 The Next Era	柗本保羽
戦闘国家日本　(自衛隊かく戦えり)	ケイ
Doggy House Hound(s)	ポチ吉
蘇り転生の魔王、絶滅寸前の魔族を救う！	shiba
高1を12回ループしたクラスメート達が賢者モードになっている件	陽乃優一
第一次「異」世界大戦	七十八十
不死の子供たち【書籍販売中】	パウロ・ハタナカ
【デス】同じ一日を繰り返すことｎ回目、早く明日を迎えたい(´；ω；｀)【ループ】	浦田　緋色 （ウラタ　ヒイロ）
剣客ウルフ	ポチ吉
終焉機ヴィクティム	梅上
絶対ハーレム世代の男子校生	馬頭鬼
深層世界のルールブック　～現実でTRPGは無理げーでは？	のらふくろう
 “冒険者アプリ”で片田舎の高校生が現代冒険者生活を送る少し未来のお話	ダイスケ
渚さんはガベージダンプを猫と歩む。	紫炎
日本時空異聞録	笠三和大
魔法貴族の領地（料理）開発	猫の人
陸上の渚 ～異星国家日本の外交～	龍乃光輝
もしも日本が他動的な理由で有人宇宙船を打ち上げる事になってしまったなら	ほうこうおんち
【完結】夜明けに微睡むヴァンパイア～♪	shiba
██▚　現代魔術は異世界をクロールするか ： 数理科学による魔術の始め方　▚██	▚ Richard Roe ▚
『インパルス』～宝くじで900億円当たったから、理想の国を作ることにした～	時雲仁
敗北者となり追放された最弱の少女は最悪の賢者に魂を売り、最強の人形と共に復讐を果たすようです ～マリオネット・プロトコル～	kiki
超魔術転生～最強の７歳の俺に嫁と娘がいた～	暁える
【蒼星のファンファーレ】〜僕をかばって死んでしまった幼馴染の彼女を救うため、二度目の世界では知識チートを活かした最強装備の機動兵器で守り抜く〜	悠木ゆう
異星の砂漠にて、人型機械は躍動す――ＭＥＴＡＬＩＣ/ＭＡＮＥＵＶＥＲＳ	中文字
終末世界へようこそ　－目覚めたら世紀末でした－	ウムラウト
鳥取県知事ですが、著書が有害図書に指定されました	戸佐アルタ
その復讐に、太古のオーバー・テクノロジーはいかがですか？　〜解雇どころか生贄にされた戦力外兵士、戦術ＡＩ少女と新国家を立ち上げ、祖国に宣戦布告する模様〜	嵯鞠　増男
我等ヴィオラ騎士団	paiちゃん
石英ガラスの高次幻争録（メタ・ファンタジア）	小鈴危一
アメイジングノービス ～異世界でチートツールが使えたけど物理法則さんが邪魔をする～	逢須 かた丸
異世界還りのおっさんは終末世界で無双する【コミック二巻発売中！】	羽々音色
小説投稿サイトでランキング一位を取らないと出られない部屋	理不尽な孫の手
【第三部開始！！】無職マンのゾンビサバイバル生活。【第二部完結！！】	秋津モトノブ
予知と解析	こる．
ゾンビがうろつく世界になったら異世界から帰ってきた俺はどうする？　ゾンビを相手に無双するよりも生き長らえるためにどこかで拠点を作りたい	蛸山烏賊ノ介
僕以外の人類はＶＲ空間に移住した	佩ロッシュ
船が沈没して大海原に取り残されたオッサンと女子高生の漂流サバイバル＆スローライフ	かるちぇ@オッサンJK漂流記
少年Ｚ	髙田野人
アクティブ・パンデミック	コロンビア
不死の配送人	ヘロー天気
メリーさん・イン・ゾンビアポカリプス～瓦礫に埋まって数十年。やっと地上に出れたと思ったら人類が滅亡寸前なんですが？～	瘴気領域
JK無双　終わる世界の救い方 	蒼蟲夕也
ゾンビになったと追放された俺は人類を救えるかもしれないけど人類は救いようがない	しゃぼてん
終焉のコドク	百舌巌
キャンプで出会った連中がたどった顛末	よぎそーと／ファンティアやってる
核シェルター付きマンションを相続した男が快適に引き籠る物語	グレゴリー
異世界帰り・オブ・ザ・デッド	時をかけたい少女
2126年　状態：生存	паранойя
スローライフ・オブ・ザ・デッド	ぺんぎん
滅亡世界と安価スレ	西沢東＠コミカライズ企画進行中！
Crawler's	水川湖海
その国の終焉	高月水都
崩壊世界で目覚めたら馴染みのあるロボを見つけたので、強気に生き抜こうと思います	ユーリアル
レッドサンブラックムーン -機密解除された第二次大戦における＜異世界からの干渉＞および＜魔獣との戦闘＞に関する記録と証言について-	弐進座
日韓戦争・日本海炎上――日本国自衛隊vs大韓民国国軍――	河畑濤士
終焉の世界でゾンビを見ないままハーレムを作らされることになったわけで…	緑豆空
無人島パラドックス――我、無人島にてイケメンに勝利せり――	大舞 神
聖女の半分は優しさで出来ています～キル・オール・エネミー～	銀星石
謎の密室で目を覚ましたら、知らない男の声が「さあゲームの始まりだ」とか何とか言っているが、そんなことよりも今すぐトイレに行かないとヤバい。	やまだのぼる
エンディング後の世界を生き残る僕ら	ゆうき
[連載版] トロル	舛本つたな
ベジタリアンテレパシスト	キムラ
プレッパー・サバイバー〜ゾンビ？地震？終わった世界で必要なのはチートでなく知識です。俺を追い出したクラスメイト、今更戻ってきてと言ってももう遅い！〜	山田 時裕
アンデッド・アポカリプス　～ゾンビに嫌われた俺が行く終末世界～　	鬼管いすき
交錯世界の日章旗	名も無き突撃兵
俺を召喚したせいで異世界が魔力を使い切ったようです	昼熊
ムゲンループのカシコイ生き方	koutori
戦場のフロンティア 　～気がついたら銃と兵器のゲーム世界に生産職で転生してた～	邑上主水
2 : 8	松浦アエト
無人島サバイバル　How to survive on a desert island.	綿貫瑞人
星姫計画	クンスト
ゆき　～東京を、史上最大の降雪が襲うとき～	兎津母
ガルディシア帝国の興亡	酒精四十度
世界にゾンビが溢れても、うちだけは安全だ	くまのき
梅花、百鬼を魁る	色付きカルテ
もしも悪役令嬢が世紀末覇者だったら	ユート
【緊急】村で人喰いモンスターが暴れてるらしい【事態】	カズキ@積みディスク消化中
その人の名は狂気――influence panic――	無道
「ローソン、サハラ砂漠中央店？」	ＭＵＭＵ
終焉の世界でゾンビを見ないままハーレムを作らされることになったわけで… サイドストーリー	緑豆空
元勇者のおじいさんと元聖女のおばあさんが秒で全てを解決する昔話	たなか
泉の女神に恋をした俺は金の斧も銀の斧もいらない。	しいたけ
もう遅いと言われた男の話	曲尾　仁庵
世界で一番醜い娘と世界で一番美しい若者	楠瑞稀
各方面に配慮した桃次郎と桃子[かくほうめんにはいりょしたももじろうとももこ]（順不同）≪ふりがなつき≫【There’s English】	たなか
どうぞ。おなかをなでてください。	りすこ
星が泣いたあの日に起きたこと	海野宵人
魔王に拐われた姫が勇者に嫁ぐ話	冬里 尊
詐欺師がついた最後の嘘	はなまる
星降る夜に落ちた子	千東風子
一人だけ難易度が明らかにおかしいかぐや姫	しいたけ
世界で一番口の悪い教師	みなもとさとり
果たされる約束	朝野りょう
薬草転生物語	鬼影スパナ
お掃除をしていたら幸せになった、片付け下手なOLさんのおはなし	石河 翠
金の斧と銀の斧と普通の斧を纏めて泉へ投げ込んでみた	しいたけ
流れ星と皇子	小田 ヒロ
物語のつぼと魔女	風羽洸海
メスガキの恩返し	やまおか
魔法の鏡が王妃を好きすぎる	たらこくちびる毛
それから後のシンデレラ	瀬嵐しるん
人魚姫はビッチな姉たちのあれやこれやでバッドエンドを回避する	くろつ
仕切り屋 シンデレラ	瀬嵐しるん
わたしにしか見えない王子さま　	小択出新都
消えた王国	千東風子
【完結】桃太郎の養子は鬼が倒せず追放される。前世知識ときびだんご作って、かわいい妹ともふもふ達に囲まれ、のんびり暮らします。	東夷
冬の王と春の妃	ピヨ/七海ちよ
魔王は玉座で「もう遅いのだ」とつぶやいた	曲尾　仁庵
世界を救った聖女のおはなし	辺野 夏子
腐界の王	曲尾　仁庵
もしも浦島太郎が助けた亀に連れられて行ったのが竜宮城ではなく深淵に眠る名状しがたき旧き神を祀る海底神殿だったら	チンチラすずめ
名もなき女神はサービス過剰	瀬嵐しるん
世間に虐げられしおっさんは実は聖女でしたが、今日も楽しく過ごします	ベキオ
野原の小さな魔女	高菜あやめ
捨て子のエイプリルと、忘れられたぬいぐるみの王子さま	石河 翠
剣振りかぶり姫	夕景あき
ローズお姉さまのドレス	有沢真尋
森の中の不思議なお店	どんC
お父さまが『けいやくけっこん』したおあいては、イケメンマッチョなお兄さまでした。	砂礫零
白雪姫とちびふわ	桜瀬彩香
少女は雲を洗う	瀬嵐しるん
スライムのよろず屋さん　～すごいけどすごくないお店に今日も遊びに行きます～	森野
うっかり湖に斧を落としたら　怒った神が浮上した	瀬嵐しるん
小さな歌姫と大きな騎士さまのねがいごと	石河 翠
本当はとても邪神な童話集	北瀬野ゆなき
魔法使いはとっくに来てた	瀬嵐しるん
深海の魔女は呪うのがお好き	サクモ明葉
ひとりぼっちの精霊さま	ひつじのはね
百貫姫にまつわる三つの物語	楠瑞稀
赤ずきんと灰色狼	桜瀬彩香
読み専が紹介する『なろうお気に入り作品』	ひょろ
ブクマや評価を入れてくれれば連載します？ふぅん、じゃあ連載始まったらブクマと評価外すね？	燦々SUN
最近のランキング、なんだかなぁどころじゃねえ。	時の権能者
好きななろう作家さんが書籍化デビューしたけど、絵師が生理的に無理だった場合	心の中で炎上中
最近のランキング、なんだかなぁと思う。	時の権能者
感想で作者に筆を折らせた方、楽しかったですか？	静
拝啓　エタりそうな作者様、エタが嫌いな読者様。これがなろうの現実です。	応援されたい作者
小説家になろう　ランキング上位にいくための、不正なポイント稼ぎについて	森永ピノ子
長文説明型タイトルの問題点について	丘/丘野　優
ある日突然、私の口座に間違って二千万が振り込まれたときの話	新道 梨果子
アダルト広告は排除して欲しいという切なる願い！	椎名ユズキ
プークスクス！　どれだけ面白い小説書いた所であなたの話なんて誰も読みませんからｗｗｗ	熊ノ翁
行きつけのインド人がやってるカレー屋でたまたま七福神の話題になったとき、七福神の中にインド人が３人いるよと教えたら、インド人のテンション⬆⬆になった話	ξ˚⊿˚)ξ ただのぎょー
最弱装備として有名な『かわのたて』を作ってみて思うこと（写真付き）	中々中（旧：フェフオウフコポォ）
短編詐欺が損をする	はとさぶれ
こんな感想は嫌われる！？作家がモヤる”悪気の無い感想”７選	とびらの
調子にのって『ひのきのぼう』も作ってみた。あと『かわのたて』も改良してみた（写真付き）	中々中（旧：フェフオウフコポォ）
神戸製鋼の件でいい機会だし、アルミについて見直すべきことを主張してみたいと思う。	御代出　実葉
文系脳でごめんなさい	中村 颯希
熊エッセイ2021	熊ノ翁
盗作の末路	秋口峻砂
札幌の市街地に出たヒグマについて、感覚が麻痺した北海道民の反応。	遊び怠惰
メンテナンスによって大幅に評価方法が変わったよ！！！！	時の権能者
なうろう作家とメガミ様	昼熊
ざまぁ・追放　いざ書く側に回ると立ちはだかる常識の壁	射手川
ツバメの雛さまが巣から落ちてこられたのでお育て申し上げた件	けも
なぜ追放、ざまあがランキングを席巻するのか？　短時間消費型コンテンツ化する「小説家になろう」と、新人作家への提言	長谷川凸蔵
書籍化の打診が来ています　－出版までの遠い道のり－	ダイスケ
なろう小説はこれだから嫌いだ！　とお嘆きのあなたに。ランキング以外の作品の探し方、お伝えします。	すー
熊エッセイ2022	熊ノ翁
助けてもらう側なのに、どうしてそんなに偉そうなんですか？	ホーリョ
警察に捕まりました　～そして、現代社会の闇を見た～	仙道アリマサ
小説家になろうができる前から活動している私が、小説家になろうが流行る前に活動休止して最近復帰して思う今と昔	沢野いずみ
異世界でマヨネーズ無双をしようとした結果	高井うしお＠百花娘々10／17コミック発売
底辺作者集まれ～ 目指せ脱0pt！ なろう連載投稿時間のススメ	笹座 昴
誤字報告機能ありがたいけど、要点だけ書いて欲しい……！	港瀬つかさ
『小説家になろう』の『ボーイズラブ』タグって意味あるの？	三谷玲
読みたくない作品？ えっ、読まなければいいだけでは^q^	Kei.ThaWest
不毛な喧嘩、不毛な努力、ここが変だよ“なろう界隈”	冬月光輝
銀河英雄伝説論　大人になってから分かるヤンの非常識さ	加藤　良介
『なろう用語の基礎知識』第七稿	ξ˚⊿˚)ξ ただのぎょー
誰でも分かる！小説の書き方入門	青い鴉
解明され始めた新型コロナの本当の死因のメカニズム　～ウィルスそのものが人を死に至らせるわけではなかった～　期待される日本株BCGとは？	御代出　実葉
富岳の世界一速いスーパーコンピューターという表現は厳密には正しくない。正確には現時点にて世界一高速処理できるサーバーである。	御代出　実葉
沖縄人が騙る中国脅威論と法案反対派への反証	粛
小説家になろう　あなたが信じる『評価数』・『ブックマーク数』を――『ぶっ壊す』。２０１６改訂版	森永ピノ子
誤字報告機能という紙アプデがきたああああああ	ひょろ
最近の『小説家になろう』のランキングについて、いくらなんでもこれは酷いと思ったしがない作品投稿者の怒りと憤りの話	佐々木鏡石@『じょっぱれアオモリの星』12/28書籍発売
【作者様にお願い】まずは登場人物の名前をググりましょう！！	琥珀
ライトノベルは衰退しました！	熊ノ翁
俺の作品に１：１とか２：２とかふざけた点数をつけたクソどもへ。	ZUZU
ブクマ外しの悲しみを全世界に訴えるうた	黒塔真実
書籍化さえしなければ、君は今でも書き続けていただろうか？	しゃもじ
0pt小説は砂漠であり、愉快な旅でもある	岬林　守
吾輩は猫である。名は既にあるのだが、まだ増えるもよう。	夕立
ブクマはがされ川柳	殿水結子
盗賊の娘	りったん
なろうの星	小さい星の住人
烏になった母鳥	三香
なろうあるある川柳	殿水結子
嘘つきの告白	うわの空
異世界転生あるある川柳	暮伊豆
ママさんなろう作家あるある川柳	殿水結子
エタるな危険	はいおく まんたん
＊あるオタクから一般の人へのお願い＊	桜井あんじ
subtle	水野葵
死ねば感動するんだろう？	トネリコ
退会	ひだまりのねこ
『小説家になろう』でなかなかアクセス数が伸びない貴方に	Past (菊川睡蓮)
なろう学園☆底辺組！！　オープニング	戸森鈴子
なろうで長編は不遇だぞ川柳	殿水結子
春が来れば、いなくなる	みこと。
誰かの心に刺さっているんだ！	椎名ユズキ
誤字報告の詩（運営さんへ捧ぐ詩）	闇黒猫虎
ワクチン接種あるある川柳	殿水結子
詩集（うたあつめ）	藤乃 澄乃
椎名ユズキ 詩集〜月のうさぎ	椎名ユズキ
異世界で楽しく平和な学園生活を送るために贈る言葉	たなか
だから俺はエタらせる	間咲正樹
ぱりぱりぱりり	みこと。
なろうスコッパーあるある川柳	殿水結子
ただ風に揺れるのを見ていたい	水渕成分
底辺作家あるある川柳	殿水結子
書籍化作家あるある川柳	殿水結子
とおのみち	暮伊豆
ブックマークが減った時	椎名ユズキ
桜吹雪	中村尚裕
みんなすごい人	平民のひろろさん
メッセージ・イン・ア・ボトル	ξ˚⊿˚)ξ ただのぎょー
そんな私を許してね	みこと。
深呼吸	なななん
恋は花火のように	しましまにゃんこ
失敗しろ	たらこくちびる毛
言いたいけど、言いたくないねん	秋の桜子
ブクマ押しちゃう川柳	殿水結子
らびゅー	鞠目
愛あらば微笑まん	香月よう子
大好き！	七生
途切れ道	暮伊豆
孤独な男	暮伊豆
NW3リプレイ『転生者症候群』	鰤／牙
もし三國志の呂布がアリストテレスの倫理学を学んだら	かずさん
アリアンロッドRPG2Eリプレイ・友情は闘いの果てに咲くものですよね！	巻野ぐるぐる
『なまこ×どりる』TRPGリプレイ！（嘘）	ξ˚⊿˚)ξ ただのぎょー
ソードワールドTRPGリプレイ　～狼少年はさかまく螺旋の少女に出会う～	狼子　由
ボク達生活冒険者	シムCM
百錬の覇王、異世界魔王、オバロの違いから何が許され何が許されないか調べてみた	ラピさん
そしてみんなどこへいった	アホリアＳＳ
SW2.0リプレイ『穢れの酒を飲む方法』	仙茶
おっさん牛丼史　	愛猫家　奴隷乙
ログ・ホライズンＴＲＰＧリプレイ『破滅の鍵をとりもどせ！』	相馬将宗
二人の英雄だけが知っている	Shoot
ドラゴンアームズ改リプレイ『オペレーションアンカーブレイク』	グリップダイス
ᓚᘏᗢ　猫ギロチン～ＲＰＧ風ある日の出来事～　ᗢᘏᓗ	山目　広介
TRPGリプレイ小説～GMの胃は死んだ編～	極振り大好きおじさん
トーキョーＮ◎ＶＡリプレイ　グリップダイス的日常	グリップダイス
アリアンロッド2E・リプレイ・ビギナーズ　LV1「この鍋には肉がないっ！」	黒兎そよ
んもーっ！　どうして水平射撃だと凄いのか――クロスボウは水平射撃をしてない	curuss
ソード・ワールド2.0リプレイ「ご主人様はウサギですか？」	グリップダイス
僕らのSW2.0リプレイ～すぐに終わった冒険～	林田草男
ソード・ワールド2.0布教用リプレイ　『ミストキャッスル　－蛮都からの生還－』	神楽風月
ログ・ホライズンTRPGリプレイ　あの景色を見たくて	CUTLET
ソードワールド2.0リプレイ・無法都市ナインテイル	SHIN12
霊は家屋に宿るもの？（タマゲッターハウス：リプレイの怪）	アホリアＳＳ
アリアンロッド２Ｅ・リプレイ・ダイジャスティス	ちありす
ダブルクロス キャンペーンリプレイ:レネゲイドウォー	御巫咲絢
とあるネット記事に感じたこと	愛猫家　奴隷乙
メタリックガーディアンRPGリプレイ　『蕾よ花開け』	りょーさん
アリアンロット２E・リプレイ「対決！シリアルキラー！！」	烏妣 揺と愉快な仲間たち
血風領のニューフェイス	鏑木ハルカ
西部劇マギシューキャンペーン	細目魔王
メタリックガーディアンRPGリプレイ	黄粋
リサイクルを発展させるには	百（難しい童話）
知らぬが仏？　　知らないってこと程、怖いことはない？　　あるアメリカ女性の実話です。「改訂版」	観不思議境　非想天
その恋、応援します！！	秋元智也
聖女の年齢制限	くれふじ
プログラム小説『javascriptでプログラム小説を書こう！』	ぼっけんさん
半生ゲーム	池戸悠
人災派遣TRPGリプレイ	紫電改
SW2.5　リプレイ　奈落の大迷宮〈アビス・ラビュリンス〉	baia=vira
果てなき世界	葉月みつは
本の虫	夕野紅葉
星のない空に輝く光を～オリーブ色の六等星～	采火
思い込みで自分を最強と化したお兄ちゃん（３０歳）が魔王討伐で無双し始めます（イラスト付き）	ぷれみあむ猫パンチ
うぁぁぁーお！寝過ごした	秋の桜子
モノトーンミュージアムRPG「Cage」キャンペーン	雛盛つくね
視界が豊かになりますように	弥禾
ガーデンオーダーリプレイ『風見鶏、炎上』	グリップダイス
【SW2.0】虹夢亭【キャンペーンリプレイ】	赤星
最強走り屋決定戦！！！！	石田　昌行
異世界コンサル株式会社（旧題：冒険者パーティーの経営を支援します！！）	ダイスケ
魔王軍最強の魔術師は人間だった	羽田遼亮
出ていくのも『優しさ』ですから	さおん
よし、逃げましょう	RIN
《書籍1巻発売中》神様の予言書『俺の未来がアニメでは雑魚死だったので拒否します』　旧題『悪役もみんな生きている』	語部マサユキ
最近のなろう読者の質低下が半端ない件　終幕	さとうカンパニー
勇者「魔王倒したし帰るか」	湯葉
準備万端な異世界召喚	優木凛々
悪役令嬢、必要ないからと追い出されたら国が滅びました。	ポンキチ
【完結】覆水盆に返らず～最悪な初対面なのに好きになるわけない！後悔してももう遅い！～	みなと
ある悪役令嬢からの手紙	端野ハトコ
わたしが悪女と罵られることになった理由	あさな
僕の諭吉おじさん	greed green/見鳥望
【無双】底辺農民学生の頑張り物語【してみた】	カズキ@積みディスク消化中
そんなつもりはなかった？　ではどういうつもりだったのですか	猫宮蒼
あなた、だれ？	十蛇秋紅
上位種に転生出来るらしいので、前世の母国を滅ぼすことにする	燦々SUN
字書きが筆を折りそうになった話	まきぶろ
聖女と呼ばれた悪役令嬢	りったん
【本編電子書籍＆POD化】神様のドＳ!!　番外編置き場	藍上イオタ
氷の滅慕	SH
大丈夫だよ、僕はずっと側にいるよ	棗
あなたが母親の手料理を食べられる回数は、残り328回です。	うわの空
ざまぁするのが悪役令嬢だけとは限らない件	猫宮蒼
ざまぁはとっくに終了しました	猫宮蒼
最近のなろう作者の質の低下が半端ない件	木工職人
【書籍化しました！】鉱石令嬢～没落した悪役令嬢が炭鉱で一山当てるまでのお話～	甘味亭太丸
夫は愛人に夢中ですが、私は気になりません	ひつじかい
いきなり原作を変えてしまって、すいません。　～少年マンガの世界に転生しました～	浅葱零
小説家になろうが冒険者ギルドだったら	昼熊
魅了魔法の正しい使い方	馬場翁
大嫌いな令嬢	緑谷めい
エルサティーナの笛吹姫	小択出新都
なろうの異世界ものを語るスレ	ID:dt30++/6
愛するが故に	ひつじかい
婚約破棄からの国外追放でざまぁとかもう遅い	大貞ハル
０から始める小説の書き方徹底講座！	N.M.ぺんくらぶ
婚約破棄された娘は死んだ婚約者に復讐をする	更科　郡
転生しました。乙女ゲー世界の悪役令嬢――――――の取り巻きその３に。	新田　葉月
こんなのは「小説家になろう」じゃない！	たこす
因果はめぐる	田中
ゲームの通りなん・です・が……	嘉胡きわみ
友情とかないです	猫宮蒼
転生喪女の異世界暮らし～魔法と商売、一番最後に恋愛を～	灰猫
王子が婚約破棄宣言した結果	猫宮蒼
追放？　あぁ、契約解除って事ですね	猫宮蒼
え、今更？　手遅れに決まってるじゃないですか	猫宮蒼
巻き込まれた僕達は	波留まち（Halmachi）
こんにちは赤ちゃん	いときりばさみ
原作改変に臨んだ結果	猫宮蒼
ログ・ホライズン	橙乃ままれ
多神の加護	masanimasa
先代勇者は隠居したい(仮題)	タピオカ
風と異邦の精霊術師	山際小道
第三王子エルメル	せい
盟約の花嫁	徒然
義妹が勇者になりました。	縞白
腕白関白・改定版	そる
地面を愛した男	もりぶりん
遅咲き冒険者（エクスプローラー）	安登　恵一
チート薬師の異世界旅（旧題:神様？チート異世界転移で薬師旅）	赤雪トナ
異世界の愚か『もの』　～世界よ変われ～	ahahaha
New　World 	池宮樹
魔法使いと風精霊	田中２３号
ウルフバレル５．５６	土田ナオ
その女、悪女です！　いいえ、それは濡れ衣です。	サディラ
水の理	古流　望
異世界行商譚	あさ
地味な青年の異世界転生記	鵜　一文字
裏切られた勇者のその後……	飯田栄静＠市村鉄之助
迷宮世界グリンドワールド	吉岡
蝉だって転生すれば竜になる	あぶさん
俺の人生ヘルモード	侘寂山葵
塔の上の悪役令嬢	相川イナホ
ちぇんぢ！！	草加人太
転生したった　	空乃無志
アルテナの箱庭が満ちるまで	赤野用介
攻略なんぞされてたまるか！	井平遼
ゲームの世界で第二の人生！？	シェイフォン
撃ち抜いたのは	歌瑞
ギリギリアウトかもしれない異世界	kameo
脇役勇者は光り輝く	三嶋　与夢
異世界ツーリング	おにぎり
ROBOT HEART 【1】	Cat Bell
異世界紳士録	ガー
刹那の破片	緑青・薄浅黄
チートだけど宿屋はじめました。	nyonnyon
死が二人を分かつとも	秋月
別の世界で生きていく条件	招きダンボー
結構ハードな乙女ゲーの世界	ニネコ
望まない結婚	小鶴
ダンジョン発掘物語　	Ｙ．Ａ
『勇者』の反逆	本場匠
異世界で生活することになりました	ないとう
剣と魔法の世界なんて、現代技術の敵じゃない！	一八四
異世界で生きていく方法	神野光典　（旧　こでんかんの）
WILD FRONTIER ～虹色異世界冒険譚～	シーサイド地蔵
鈍色のパラディン	チノフ
クライ・フリーダム	力野　十三
ああ勇者、君の苦しむ顔が見たいんだ	ユウシャ・アイウエオン
